Baltimore	Baltimore Orioles	Oriole Park at Camden Yards
Boston	Boston Red Sox	Fenway Park
Chicago	Chicago White Sox	Guaranteed Rate Field
Cleveland	Cleveland Indians	Progressive Field
Detroit	Detroit Tigers	Comerica Park
Houston	Houston Astros	Minute Maid Park
Kansas City	Kansas City Royals	Kauffman Stadium
Anaheim	Los Angeles Angels	Angel Stadium
Minneapolis	Minnesota Twins	Target Field
Bronx	New York Yankees	Yankee Stadium
Oakland	Oakland Athletics	Oakland Coliseum
Seattle	Seattle Mariners	T-Mobile Park
Tampa Bay	Tampa Bay Rays	Tropicana Field
Arlington	Texas Rangers	Globe Life Park in Arlington
Toronto	Toronto Blue Jays	Rogers Centre
Phoenix	Arizona Diamondbacks	Chase Field
Atlanta	Atlanta Braves	SunTrust Park
Chicago	Chicago Cubs	Wrigley Field
Cincinnati	Cincinnati Reds	Great American Ball Park
Denver	Colorado Rockies	Coors Field
Los Angeles	Los Angeles Dodgers	Dodger Stadium
Miami	Miami Marlins	Marlins Park
Milwaukee	Milwaukee Brewers	Miller Park
New York	New York Mets	Citi Field
Philadelphia	Philadelphia Phillies	Citizens Bank Park
Pittsburgh	Pittsburgh Pirates	PNC Park
San Diego	San Diego Padres	Petco Park
San Francisco	San Francisco Giants	Oracle Park
St. Louis	St. Louis Cardinals	Busch Stadium
Washington	Washington Nationals	Nationals Park
